1111111111111111111
1010001000000000001
1010101110101111101
1000100010100010101
1111111011111010101
1000001000000010101
1010111111111110101
1010000000100000001
1011111110101111111
1000001010001000001
1111101011111011101
1010001000001000101
1010111110101011101
1000100010100010001
1011101011101110101
1000001000100010101
1111111110111110101
1000000000000000101
1111111111111111111
